318
263
15

0 0 0 0 0 0 0 0 0 0 1 0 0 0 0 0 0 0 0 0 0 0 0 0 0 0 0 2 0 0 0 0 0 0 0 0 0 0 0 0 0 0 3 0 0 0 0 0 0 0 0 0 0 0 0 0 0 0 2 0 0 0 2 0 0 0 2 0 3 3 3 0 0 0 0 1 0 0 0 1 0 0 0 1 0 0 0 0 0 0 

2 0 0 0 2 0 0 0 2 0 3 3 3 0 0 0 0 1 0 0 0 1 0 0 0 1 0 0 0 0 0 0 0 2 0 2 0 1 0 0 3 3 3 3 0 0 0 0 0 2 0 2 0 1 0 0 3 3 3 3 0 0 0 0 0 2 0 2 0 1 0 0 3 3 3 3 0 0 0 0 0 2 0 2 0 1 0 0 4 0 3 0 2 0 1 0 0

1 0 2 0 1 0 2 0 1 0 2 0 1 0 2 0 3 0 4 0 3 0 4 0 1 0 2 5 3 0 0 0 1 0 2 0 1 0 2 0 1 0 2 0 1 0 2 0 3 0 4 0 3 0 4 0 1 0 2 5 3 0 0 4 0 0 2 0 2 0 0 3 3 3 3 3 0 0 0 4 0 0 2 0 2 0 0 0 4 0 0 2 0 2 0 4 0 0 2 0 2 0 0 0 3 3 3 3 3 0 0

4 0 0 2 0 2 0 0 0 4 0 4 0 4 0 4 0 0 3 0 3 0 3 0 2 1 0 4 0 0 0 0 1 0 0 0 2 0 0 0 3 0 3 0 0 0 4 0 5 0 3 0 3 0 3 0 2 1 0 4 0 0 0 0 1 0 0 0 2 0 0 0 3 0 3 0 0 0 4 0 5 0 3 0 3 0 3 0 2 1 0 4

0 0 0 0 1 0 0 0 2 0 0 0 3 0 3 0 0 0 4 0 5 0 3 0 3 0 3 0 2 1 0 4 0 0 0 0 0 0 0 0 0 0 0 0 0 0 0 0 0 0 0 0 0 4 0 2 0 2 0 1 0 0 3 3 3 3 0 0 0 0 0 2 0 2 0 1 0 0 3 3 3 3 0 0 0 0 0 2 0 2 0 1 0 0 3 3 3 3 0 0 0 0 0 2 0 2 0 1 0 0 4 0 3 0 2 0 1 0 0

1 0 2 0 1 0 2 0 1 0 2 0 1 0 2 0 3 0 4 0 3 0 4 0 1 0 2 5 3 0 0 0 1 0 2 0 1 0 2 0 1 0 2 0 1 0 2 0 3 0 4 0 3 0 4 0 1 0 2 5 3 0 0 4 0 0 2 0 2 0 0 3 3 3 3 3 0 0 0 4 0 0 2 0 2 0 0 0 4 0 0 2 0 2 0 4 0 0 2 0 2 0 0 0 3 3 3 3 3 0 0

4 0 0 2 0 2 0 0 4 0 4 0 4 0 4 0 0 3 0 3 0 3 0 2 1 0 4 0 0 0 0 1 0 0 0 2 0 0 0 3 0 3 0 0 0 4 0 5 0 3 0 3 0 3 0 2 1 0 4 0 0 0 0 1 0 0 0 2 0 0 0 3 0 3 0 0 0 4 0 5 0 3 0 3 0 3 0 2 1 0 4

0 0 0 0 1 0 0 0 2 0 0 0 3 0 3 0 0 0 4 0 5 0 3 0 3 0 3 0 2 1 0 4 0 0 0 0 0 0 0 0 0 0 0 0 0 0 0 0 0 0 0 0 0 4 0 2 0 2 0 1 0 0 3 3 3 3 0 0 0 0 0 2 0 2 0 1 0 0 3 3 3 3 0 0 0 0 0 2 0 2 0 1 0 0 3 3 3 3 0 0 0 0 0 2 0 2 0 1 0 0 4 0 3 0 2 0 1 0 0

1 0 2 0 1 0 2 0 1 0 2 0 1 0 2 0 3 0 4 0 3 0 4 0 1 0 2 5 3 0 0 0 1 0 2 0 1 0 2 0 1 0 2 0 1 0 2 0 3 0 4 0 3 0 4 0 1 0 2 5 3 0 0 4 0 0 0 3 0 0 0 0 0 0 0 0 0 0 0 4 0 0 0 3 0 0 0 1 0 3 0 2 0 4 0 4 0 0 0 3 0 0 0 0 0 0 0 0 0 0 0 4 0 0 0 3 0 0 0 1 0 3 0 2 0 4 0

3 0 3 0 3 0 2 1 0 4 0 0 0 0 1 0 0 0 2 0 0 0 3 0 3 0 0 0 4 0 5 0 3 0 3 0 3 0 2 1 0 4 0 0 0 0 1 0 0 0 2 0 0 0 3 0 3 0 0 0 4 0 5 0 3 0 3 0 3 0 2 1 0 4

0 0 0 0 1 0 0 0 2 0 0 0 3 0 3 0 0 0 4 0 5 0 3 0 3 0 3 0 2 1 0 4 0 0 0 0 0 0 0 0 0 0 0 0 0 0 0 0 0 0 0 0 0 4 0 2 0 2 0 1 0 0 3 3 3 3 0 0 0 0 0 2 0 2 0 1 0 0 3 3 3 3 0 0 0 0 0 2 0 2 0 1 0 0 3 3 3 3 0 0 0 0 0 2 0 2 0 1 0 0 4 0 3 0 2 0 1 0 0

1 0 2 0 1 0 2 0 1 0 2 0 1 0 2 0 3 0 4 0 3 0 4 0 1 0 2 5 3 0 0 0 1 0 2 0 1 0 2 0 1 0 2 0 1 0 2 0 3 0 4 0 3 0 4 0 1 0 2 5 3 0 0 4 0 0 0 3 0 0 0 0 0 0 0 0 0 0 0 4 0 0 0 3 0 0 0 0 0 0 0 0 0 0 0 4 0 0 0 3 0 0 0 0 0 0 0 0 0 0 0 0 4 0 0 0 3 0 0 0 1 0 3 0 2 0 4 0

3 0 3 0 3 0 2 1 0 4 0 0 0 0 1 0 0 0 2 0 0 0 3 0 3 0 0 0 4 0 5 0 3 0 3 0 3 0 2 1 0 4 0 0 0 0 1 0 0 0 2 0 0 0 3 0 3 0 0 4 0 5 0 3 0 3 0 3 0 2 1 0 4

-1

0 0 0 0 0 0 0 0 0 0 3 0 0 0 0 0 0 0 0 0 0 0 0 0 0 0 0 2 0 0 0 0 0 0 0 0 0 0 0 0 0 0 4 0 0 0 0 0 0 0 0 0 0 0 0 0 0 0 0 0 3 0 0 0 3 0 0 0 0 0 0 1 1 1 0 0 0 2 0 0 0 2 0 0 0 0 0 0 0 0

0 0 3 0 0 0 3 0 0 0 0 0 0 1 1 1 0 0 0 2 0 0 0 2 0 0 0 0 0 0 0 0 0 0 3 0 2 0 2 0 0 0 0 0 1 1 1 1 0 0 3 0 2 0 2 0 0 0 0 0 1 1 1 1 0 0 3 0 2 0 2 0 0 0 0 0 1 1 1 1 0 0 3 0 2 0 2 0 0 1 0 4 0 2 0 3 0

2 0 3 0 2 0 3 0 2 0 3 0 2 0 3 0 4 0 1 0 4 0 1 0 2 0 3 5 4 0 0 0 2 0 3 0 2 0 3 0 2 0 3 0 2 0 3 0 4 0 1 0 4 0 1 0 2 0 3 5 4 0 0 0 0 1 0 3 0 0 0 4 4 4 4 4 0 0 0 0 0 1 0 3 0 0 0 0 0 0 1 0 3 0 0 0 0 1 0 3 0 0 0 0 4 4 4 4 4 0 0

0 0 1 0 3 0 0 0 0 1 0 1 0 1 0 1 0 0 4 0 4 0 4 0 2 3 0 1 0 0 0 0 0 0 3 0 0 0 2 0 0 1 0 0 0 0 5 0 1 0 4 0 4 0 4 0 2 3 0 1 0 0 0 0 0 0 3 0 0 0 2 0 0 1 0 0 0 0 5 0 1 0 4 0 4 0 4 0 2 3 0 1

0 0 0 0 0 0 3 0 0 0 2 0 0 1 0 0 0 0 5 0 1 0 4 0 4 0 4 0 2 3 0 1 0 0 0 0 0 0 0 0 0 0 0 0 0 0 0 0 0 0 0 0 0 0 1 0 3 0 2 0 2 0 0 0 0 0 1 1 1 1 0 0 3 0 2 0 2 0 0 0 0 0 1 1 1 1 0 0 3 0 2 0 2 0 0 0 0 0 1 1 1 1 0 0 3 0 2 0 2 0 0 1 0 4 0 2 0 3 0

2 0 3 0 2 0 3 0 2 0 3 0 2 0 3 0 4 0 1 0 4 0 1 0 2 0 3 5 4 0 0 0 2 0 3 0 2 0 3 0 2 0 3 0 2 0 3 0 4 0 1 0 4 0 1 0 2 0 3 5 4 0 0 0 0 1 0 3 0 0 0 4 4 4 4 4 0 0 0 0 0 1 0 3 0 0 0 0 0 0 1 0 3 0 0 0 0 1 0 3 0 0 0 0 4 4 4 4 4 0 0

0 0 1 0 3 0 0 0 1 0 1 0 1 0 1 0 0 4 0 4 0 4 0 2 3 0 1 0 0 0 0 0 0 3 0 0 0 2 0 0 1 0 0 0 0 5 0 1 0 4 0 4 0 4 0 2 3 0 1 0 0 0 0 0 0 3 0 0 0 2 0 0 1 0 0 0 0 5 0 1 0 4 0 4 0 4 0 2 3 0 1

0 0 0 0 0 0 3 0 0 0 2 0 0 1 0 0 0 0 5 0 1 0 4 0 4 0 4 0 2 3 0 1 0 0 0 0 0 0 0 0 0 0 0 0 0 0 0 0 0 0 0 0 0 0 1 0 3 0 2 0 2 0 0 0 0 0 1 1 1 1 0 0 3 0 2 0 2 0 0 0 0 0 1 1 1 1 0 0 3 0 2 0 2 0 0 0 0 0 1 1 1 1 0 0 3 0 2 0 2 0 0 1 0 4 0 2 0 3 0

2 0 3 0 2 0 3 0 2 0 3 0 2 0 3 0 4 0 1 0 4 0 1 0 2 0 3 5 4 0 0 0 2 0 3 0 2 0 3 0 2 0 3 0 2 0 3 0 4 0 1 0 4 0 1 0 2 0 3 5 4 0 0 0 0 4 0 0 0 1 0 0 0 0 0 0 0 0 0 0 0 4 0 0 0 1 0 3 0 4 0 2 0 1 0 0 0 4 0 0 0 1 0 0 0 0 0 0 0 0 0 0 0 4 0 0 0 1 0 3 0 4 0 2 0 1 0

4 0 4 0 4 0 2 3 0 1 0 0 0 0 0 0 3 0 0 0 2 0 0 1 0 0 0 0 5 0 1 0 4 0 4 0 4 0 2 3 0 1 0 0 0 0 0 0 3 0 0 0 2 0 0 1 0 0 0 0 5 0 1 0 4 0 4 0 4 0 2 3 0 1

0 0 0 0 0 0 3 0 0 0 2 0 0 1 0 0 0 0 5 0 1 0 4 0 4 0 4 0 2 3 0 1 0 0 0 0 0 0 0 0 0 0 0 0 0 0 0 0 0 0 0 0 0 0 1 0 3 0 2 0 2 0 0 0 0 0 1 1 1 1 0 0 3 0 2 0 2 0 0 0 0 0 1 1 1 1 0 0 3 0 2 0 2 0 0 0 0 0 1 1 1 1 0 0 3 0 2 0 2 0 0 1 0 4 0 2 0 3 0

2 0 3 0 2 0 3 0 2 0 3 0 2 0 3 0 4 0 1 0 4 0 1 0 2 0 3 5 4 0 0 0 2 0 3 0 2 0 3 0 2 0 3 0 2 0 3 0 4 0 1 0 4 0 1 0 2 0 3 5 4 0 0 0 0 4 0 0 0 1 0 0 0 0 0 0 0 0 0 0 0 4 0 0 0 1 0 3 0 4 0 2 0 1 0 0 0 4 0 0 0 1 0 0 0 0 0 0 0 0 0 0 0 0 4 0 0 0 1 0 3 0 4 0 2 0 1 0

4 0 4 0 4 0 2 3 0 1 0 0 0 0 0 0 3 0 0 0 2 0 0 1 0 0 0 0 5 0 1 0 4 0 4 0 4 0 2 3 0 1 0 0 0 0 0 0 3 0 0 0 2 0 0 1 0 0 0 5 0 1 0 4 0 4 0 4 0 2 3 0 1 0 0 0 0 0 0 0 0 0 0 0 0 0 0 0 0 0 0 0 0 0 0





-1