185
203
9

0
1 0 1 0  1 0 1 0  1 0 1 0  1 0 1 0
1 0 1 0  1 0 1 0  1 0 1 0  1 0 1 0
1 0 1 0  1 0 1 0  1 0 1 0  1 0 1 0
1 0 1 0  1 0 1 0  1 0 1 0  1 0 1 0
1 0 1 0  1 0 1 0  1 0 1 0  1 0 1 0
1 0 1 0  1 0 1 0  1 0 1 0  1 0 1 0
1 0 1 0  1 0 1 0  1 0 1 0  1 0 1 0
1 0 1 0  1 0 1 0  1 0 1 0  1 0 1 0
1 0 1 0  1 0 1 0  1 0 1 0  1 0 1 0

-1

0
0 0 0 0 0 0 0 0 0 0 0 0 0 0 0 0
0 0 0 0 0 0 0 0 0 0 0 0 0 0 0 0
0 0 0 0 0 0 0 0 0 0 0 0 0 0 0 0
0 0 0 0 0 0 0 0 0 0 0 0 0 0 0 0
0 0 0 0 0 0 0 0 0 0 0 0 0 0 0 0
0 0 0 0 0 0 0 0 0 0 0 0 0 0 0 0
0 0 0 0 0 0 0 0 0 0 0 0 0 0 0 0
0 0 0 0 0 0 0 0 0 0 0 0 0 0 0 0
1 0 1 0 1 0 1 0 1 0 1 0 1 0 1 0

-1