240
198
27

0 0 0 0   0 0 0 
4 0 0 0   0 0 0 0   3 0 0 0   0 0 0 0   4 0 0 0   0 0 0 0   3 0 0 0   1 0 2 0
4 0 3 0   4 0 3 0   3 0 4 0   3 0 4 0   4 0 3 0   4 0 3 0   3 0 4 0   1 1 2 2

4 4 3 3   4 4 3 3   3 3 4 4   3 3 4 4   4 4 3 3   4 4 3 3   3 3 4 4   4 3 1 2   
4 0 3 0   4 0 3 0   3 0 4 0   3 0 4 0   4 0 3 0   4 0 3 0   3 0 4 0   4 3 1 2 
4 4 3 3   4 4 3 3   3 3 4 4   3 3 4 4   4 4 3 3   4 4 3 3   3 3 4 4   4 3 1 2   
4 0 3 0   4 0 3 0   3 0 4 0   3 0 4 0   4 0 3 0   4 0 3 0   3 0 4 0   4 3 1 2 

1 0 2 0   1 0 2 0   2 0 1 0   2 0 1 0   1 0 2 0   1 0 2 0   2 0 1 0   1 1 2 2

1 1 2 2   1 1 2 2   2 2 1 1   2 2 1 1   1 1 2 2   1 1 2 2   2 2 1 1   4 3 1 2   
1 0 2 0   1 0 2 0   2 0 1 0   2 0 1 0   1 0 2 0   1 0 2 0   2 0 1 0   4 3 1 2 
1 1 2 2   1 1 2 2   2 2 1 1   2 2 1 1   1 1 2 2   1 1 2 2   2 2 1 1   4 3 1 2   
1 0 2 0   1 0 2 0   2 0 1 0   2 0 1 0   1 0 2 0   1 0 2 0   2 0 1 0   4 3 1 2 

4 0 0 0   0 0 0 0   0 0 0 0   0 0 0 0   4 0 0 0   0 0 0 0   0 0 0 0   0 0 0 0   
4 0 0 0   0 0 0 0   0 0 0 0   0 0 0 0   4 0 0 0   0 0 0 0   0 0 0 0   0 0 0 0 

0 0 0 0   0 0 0 0   0 0 0 0   0 0 0 0   0 0 0 0   0 0 0 0   0 0 0 0   0 0 0 0   
0 0 0 0   0 0 0 0   0 0 0 0   0 0 0 0   0 0 0 0   0 0 0 0   0 0 0 0   0 0 0 0   
0 0 0 0   0 0 0 0   0 0 0 0   0 0 0 0   0 0 0 0   0 0 0 0   0 0 0 0   0 0 0 0   
0 0 0 0   0 0 0 0   0 0 0 0   0 0 0 0   0 0 0 0   0 0 0 0   0 0 0 0   0 0 0 0   
0 0 0 0   0 0 0 0   0 0 0 0   0 0 0 0   0 0 0 0   0 0 0 0   0 0 0 0   0 0 0 0   
0 0 0 0   0 0 0 0   0 0 0 0   0 0 0 0   0 0 0 0   0 0 0 0   0 0 0 0   0 0 0 0   
0 0 0 0   0 0 0 0   0 0 0 0   0 0 0 0   0 0 0 0   0 0 0 0   0 0 0 0   0 0 0 0   
0 0 0 0   0 0 0 0   0 0 0 0   0 0 0 0   0 0 0 0   0 0 0 0   0 0 0 0   0 0 0 0   
0 0 0 0   0 0 0 0   0 0 0 0   0 0 0 0   0 0 0 0   0 0 0 0   0 0 0 0   0 0 0 0   
0 0 0 0   0 0 0 0   0 0 0 0   0 0 0 0   0 0 0 0   0 0 0 0   0 0 0 0   0 0 0 0   
0 0 0 0   0 0 0 0   0 0 0 0   0 0 0 0   0 0 0 0   0 0 0 0   0 0 0 0   0 0 0 0   
0 0 0 0   0 0 0 0   0 0 0 0   0 0 0 0   0 0 0 0   0 0 0 0   

-1

0 0 0 0   0 0 0 
1 0 0 0   0 0 0 0   4 0 0 0   0 0 0 0   1 0 0 0   0 0 0 0   4 0 0 0   3 0 2 0
1 0 4 0   1 0 4 0   4 0 1 0   4 0 1 0   1 0 4 0   1 0 4 0   4 0 1 0   3 3 2 2

1 0 4 0   1 0 4 0   4 0 1 0   4 0 1 0   1 0 4 0   1 0 4 0   4 0 1 0   1 4 3 2 
1 1 4 4   1 1 4 4   4 4 1 1   4 4 1 1   1 1 4 4   1 1 4 4   4 4 1 1   1 4 3 2 
1 0 4 0   1 0 4 0   4 0 1 0   4 0 1 0   1 0 4 0   1 0 4 0   4 0 1 0   1 4 3 2 
1 1 4 4   1 1 4 4   4 4 1 1   4 4 1 1   1 1 4 4   1 1 4 4   4 4 1 1   1 4 3 2 

3 0 2 0   3 0 2 0   2 0 3 0   2 0 3 0   3 0 2 0   3 0 2 0   2 0 3 0  3 3 2 2

3 0 2 0   3 0 2 0   2 0 3 0   2 0 3 0   3 0 2 0   3 0 2 0   2 0 3 0   1 4 3 2 
3 3 2 2   3 3 2 2   2 2 3 3   2 2 3 3   3 3 2 2   3 3 2 2   2 2 3 3   1 4 3 2 
3 0 2 0   3 0 2 0   2 0 3 0   2 0 3 0   3 0 2 0   3 0 2 0   2 0 3 0   1 4 3 2 
3 3 2 2   3 3 2 2   2 2 3 3   2 2 3 3   3 3 2 2   3 3 2 2   2 2 3 3   1 4 3 2 

1 0 0 0   0 0 0 0   0 0 0 0   0 0 0 0   1 0 0 0   0 0 0 0   0 0 0 0   0 0 0 0 
1 0 0 0   0 0 0 0   0 0 0 0   0 0 0 0   1 0 0 0   0 0 0 0   0 0 0 0   0 0 0 0 

0 0 0 0   0 0 0 0   0 0 0 0   0 0 0 0   0 0 0 0   0 0 0 0   0 0 0 0   0 0 0 0 
0 0 0 0   0 0 0 0   0 0 0 0   0 0 0 0   0 0 0 0   0 0 0 0   0 0 0 0   0 0 0 0 
0 0 0 0   0 0 0 0   0 0 0 0   0 0 0 0   0 0 0 0   0 0 0 0   0 0 0 0   0 0 0 0 
0 0 0 0   0 0 0 0   0 0 0 0   0 0 0 0   0 0 0 0   0 0 0 0   0 0 0 0   0 0 0 0 
0 0 0 0   0 0 0 0   0 0 0 0   0 0 0 0   0 0 0 0   0 0 0 0   0 0 0 0   0 0 0 0 
0 0 0 0   0 0 0 0   0 0 0 0   0 0 0 0   0 0 0 0   0 0 0 0   0 0 0 0   0 0 0 0 
0 0 0 0   0 0 0 0   0 0 0 0   0 0 0 0   0 0 0 0   0 0 0 0   0 0 0 0   0 0 0 0 
0 0 0 0   0 0 0 0   0 0 0 0   0 0 0 0   0 0 0 0   0 0 0 0   0 0 0 0   0 0 0 0 
0 0 0 0   0 0 0 0   0 0 0 0   0 0 0 0   0 0 0 0   0 0 0 0   0 0 0 0   0 0 0 0 
0 0 0 0   0 0 0 0   0 0 0 0   0 0 0 0   0 0 0 0   0 0 0 0   0 0 0 0   0 0 0 0 
0 0 0 0   0 0 0 0   0 0 0 0   0 0 0 0   0 0 0 0   0 0 0 0   0 0 0 0   0 0 0 0 
0 0 0 0   0 0 0 0   0 0 0 0   0 0 0 0   0 0 0 0   0 0 0 0   

-1

Estructura del archivo 
BPM
Duracion
Numero Cancion en archivos
Flechas
Botones

Código
Flechas: 1 Izquierda 2 Derecha 3 Arriba 4 Abajo 5 Bomba
Botones: 1 Abajo 2 Derecha 3 Izquierda 4 Arriba 5 Bomba

