176
289
2

0 0 0 0 0 0 0 0 0
1 0 2 0 4 0 2 0 3 0 4 0 4 0 4 0 4 0 3 0 3 0 4 0 4 1 0 2 0 4 0 2 0 3 0 4 0 4 0 4 0 4 0 3 0  
1 0 2 0 4 0 2 0 3 0 4 0 4 0 4 0 4 0 3 0 3 0 4 0 4 1 0 2 0 4 0 2 0 3 0 4 0 4 0 4 0 4 0 3 
1 0 2 0 4 0 2 0 3 0 4 0 4 0 4 0 4 0 3 0 3 0 4 0 4 1 0 2 0 4 0 2 0 3 0 4 0 4 0 4 0 4 0 3 0 3 0 4 3 3 
1 0 2 0 4 0 2 0 3 0 4 0 4 0 4 0 4 0 3 0 3 0 4 0 4 1 0 2 0 4 0 2 0 3 0 4 0 4 0 4 0 4 0 3 0 3 0 4 3 3
1 0 2 0 4 0 2 0 3 0 4 0 4 0 4 0 4 0 3 0 3 0 4 0 4 1 0 2 0 4 0 2 0 3 0 4 0 4 0 4 0 4 0 3 0 3 0 4 3 3 
1 0 2 0 4 0 2 0 3 0 4 0 4 0 4 0 4 0 3 0 3 0 4 0 4 1 0 2 0 4 0 2 0 3 0 4 0 4 0 4 0 4 0 3 0 3 0 4 3 3
1 0 2 0 4 0 2 0 3 0 4 0 4 0 4 0 4 0 3 0 3 0 4 0 4 1 0 2 0 4 0 2 0 3 0 4 0 4 0 4 0 4 0 3 0 3 0 4 3 3 
1 0 2 0 4 0 2 0 3 0 4 0 4 0 4 0 4 0 3 0 3 0 4 0 4 1 0 2 0 4 0 2 0 3 0 4 0 4 0 4 0 4 0 3 0 3 0 4 3 3
1 0 2 0 4 0 2 0 3 0 4 0 4 0 4 0 4 0 3 0 3 0 4 0 4 1 0 2 0 4 0 2 0 3 0 4 0 4 0 4 0 4 0 3 0 3 0 4 3 3 
1 0 2 0 4 0 2 0 3 0 4 0 4 0 4 0 4 0 3 0 3 0 4 0 4 1 0 2 0 4 0 2 0 3 0 4 0 4 0 4 0 4 0 3 0 3 0 4 3 3
1 0 2 0 4 0 2 0 3 0 4 0 4 0 4 0 4 0 3 0 3 0 4 0 4 1 0 2 0 4 0 2 0 3 0 4 0 4 0 4 0 4 0 3 0 3 0 4 0 4 
1 0 2 0 4 0 2 0 3 0 4 0 4 0 4 0 4 0 3 0 3 0 4 0 4 1 0 2 0 4 0 2 0 3 0 4 0 4 0 4 0 4 0 3 0 3 0 4 

-1
0 0 0 1 0 0 0 0 0 0 0 2 0 0 0 0 0 0 0 1 0 0 0 0 0 0 0 2 0 0 0 0 0 0 0 0 1 0 0 0 0 0 0 0 2 0 0 0 0 0
0 0 0 1 0 0 0 0 0 0 0 2 0 0 0 0 0 0 0 1 0 0 0 0 0 0 0 2 0 0 0 0 0 0 0 0 1 0 0 0 0 0 0 0 2 0 0 0 0 0
0 0 0 1 0 0 0 0 0 0 0 2 0 0 0 0 0 0 0 1 0 0 0 0 0 0 0 2 0 0 0 0 0 0 0 0 1 0 0 0 0 0 0 0 2 0 0 0 0 0
0 0 0 1 0 0 0 0 0 0 0 2 0 0 0 0 0 0 0 1 0 0 0 0 0 0 0 2 0 0 0 0 0 0 0 0 1 0 0 0 0 0 0 0 2 0 0 0 0 0
0 0 0 1 0 0 0 0 0 0 0 2 0 0 0 0 0 0 0 1 0 0 0 0 0 0 0 2 0 0 0 0 0 0 0 0 1 0 0 0 0 0 0 0 2 0 0 0 0 0
0 0 0 1 0 0 0 0 0 0 0 2 0 0 0 0 0 0 0 1 0 0 0 0 0 0 0 2 0 0 0 0 0 0 0 0 1 0 0 0 0 0 0 0 2 0 0 0 0 0
0 0 0 1 0 0 0 0 0 0 0 2 0 0 0 0 0 0 0 1 0 0 0 0 0 0 0 2 0 0 0 0 0 0 0 0 1 0 0 0 0 0 0 0 2 0 0 0 0 0
0 0 0 1 0 0 0 0 0 0 0 2 0 0 0 0 0 0 0 1 0 0 0 0 0 0 0 2 0 0 0 0 0 0 0 0 1 0 0 0 0 0 0 0 2 0 0 0 0 0
0 0 0 1 0 0 0 0 0 0 0 2 0 0 0 0 0 0 0 1 0 0 0 0 0 0 0 2 0 0 0 0 0 0 0 0 1 0 0 0 0 0 0 0 2 0 0 0 0 0
0 0 0 1 0 0 0 0 0 0 0 2 0 0 0 0 0 0 0 1 0 0 0 0 0 0 0 2 0 0 0 0 0 0 0 0 1 0 0 0 0 0 0 0 2 0 0 0 0 0
0 0 0 1 0 0 0 0 0 0 0 2 0 0 0 0 0 0 0 1 0 0 0 0 0 0 0 2 0 0 0 0 0 0 0 0 1 0 0 0 0 0 0 0 2 0 0 0 0 0



-1